##########################
#ZZZ===========#         #
#ZZZo o     o o#         #
#ZZZZZ         #         #
#ZZZZZ      oHo#=========#
#           oHo          #
#                        |
#oHo  oHo  oHo           |
#oHo  oHo  oHo           |
#oHo  oHo  oHo           #
###################    ###
